NO levels/herness/walls/57.xpm
SO levels/herness/walls/61.xpm
WE levels/herness/walls/65.xpm
EA levels/herness/walls/67.xpm

C 70,0,70
F 150,130,0

11111111111111111111111111111111111111111
10000000000000000000000000000000000000001
10000000000000000000000000000000000000001
10000000000000001000000001000000000000001
10001000100000001000000001000010001000101
10000000011110001000000001000111100000001
10000010000010001100000110001000010000001
10000001000011000000000000001100001000001
10000001000000100000000000100000001000001
1000000D00000001000000000100000000D000001
10000001111001000000S00000001001011110001
10000000000100000000000000000001000000001
10000000000010010000000001001000000000001
1D1111110000011100000000011100000111111D1
10000001000000000000000000000001000000001
10000000000000000111D11100000000000000001
1D1000000011100001000001000011100000001D1
10100000000000000D00000D00000000000000101
1D1000000011100001000001000011100000001D1
10000000000000000111D11100000000000000001
10000001000000000000000000000001000000001
1D1111110000011100000000011100000111111D1
10000000000010010000000001001000000000001
10000000000100000000000000000001000000001
10000001111001000000000000001001011110001
1000000D00000001000000000100000000D000001
10000001000000100000000000100000001000001
10000001000011000000000000001100001000001
10000010000010001100000110001000010000001
10000000011110001000000001000111100000001
10001000100000001000000001000010001000101
10000000000000001000000001000000000001001
11000000000000000000000000000000000000011
10000000000000000000000000000000000000001
10001000000000000000000000000000000010001
11111111111111111111111111111111111111111
