NO ./maps/assets/CONCRETE_2A.xpm
SO ./maps/assets/VENT_1A.xpm
WE ./maps/assets/TECH_1A.xpm
EA ./maps/assets/TECH_3G.xpm

F 20,22,25
C 13,14,15

11111111111111111111111111111111111111111111111111111111111111111111111111111111111111111111111111111111111111111
10000000000000000000000000000000000000000000000000000000000000000000000000000000000000000000000000000000000000001
10000000000000000000000000000000000000000000000000000000000000000000000000000000000000000000000000000000000000001
100001111000111000111110001111000011100001111100000000000111100000000000000000000000000000000000000000000000001
100001000100010000100010001000000010000000100000000000001000010000000000000000000000000000000000000000000000001
100001000100010000100010001000000010000000100000000000001000010000000000000000000000000000000000000000000000001
100001000100010000100010001111000010000000100000000000001000010000000000000000000000000000000000000000000000001
100001000100010000100010000001000010000000100000000000001000010000000000000000000000000000000000000000000000001
100001111000111000100010001111000011100000100000000000000111100000000000000000000000000000000000000000000000001
10000000000000000000000000000000000000000000000000000000000000000000000000000000000000000000000000000000000000001
10000000000000000000000000000000000000000000000000000000000000000000000000000000000000000000000000000000000000001
10000000000000000000000011000000000000000000000000000000000000000000000000000000000000000000000000000000000000001
10000000000000000000000011100000000000000000000000000000000000000000000000000000000000000000000000000000000000001
10000000000000000000001111110000000000000000000000000000000000000000000000000000000000000000000000000000000000001
10000000000000000000000011100000000000000000000000000000000000000000000000000000000000000000000000000000000000001
10000000000000000000000011000000000000000000000000000000000000000000000000000000000000000000000000000000000000001
10000000000000000000000000000000000000000000000000000000000000000000000000000000000000000000000000000000000000001
10000000000000000000000000000000000000000000000000000000000000000000000000000000000000000000000000000000000000001
10000110001100011111100111000111000110001000011100001110001101100111110000100000111000110001100110001111100001
10000100010100010000100100000100000100010100010010001000001001010010000000010000010000100010100100010010000000001
10000100010100010000100100000100000010101000010010001000001010010010000000010000010000100010100100010010000000001
10000100010100010000100100000100000001110000010010001000001010010011110000010000010000100010100111110011110000001
10000100010100010000100100000100000010101000010010001000001010010000010000010000010000100010100100010000010000001
10000110001110011111100111000111100110001100011100001110001010010111110001111100111000110001110100010111110000001
10000000000000000000000000000000000000000000000000000000000000000000000000000000000000000000000000000000000000001
10000000000000000000000000000000000000000000000000000000000000000000000000000000000000000000000000000000000000001
10000000000000000000000000000000000000000000000000000000000000000000000000000000000000000000000000000000000000001
10000000000000000000000000000000000000000000000000000000000000000000000000000000000000000000000000000000000000001
10000000000000000000000000000000000000000N00000000000000000000000000000000000000000000000000000000000000000000001
10000000000000000000000000000000000000000000000000000000000000000000000000000000000000000000000000000000000000001
10000000000000000000000000000000000000000000000000000000000000000000000000000000000000000000000000000000000000001
11111111111111111111111111111111111111111111111111111111111111111111111111111111111111111111111111111111111111111
