1111111111
1000000001
1000000001
    100001
    100001
    100001
    100001
1111100001
1N00000001
1111111111
