111111
100001
100001
100001
100001
100001
100001111111111111
100000000000000001
100000000000000001
111111111111111111
