11111111111111111111111111111111111
10000000000000000000000000000000001
10000000000000000000000000000000001
10000000000000000000000000000000001
10000000000000000000000000000000001
10000000011111111111111000000000001
1000000001            1000000000001
1000000001            1000000000001
1000000001            1000000000001
1000000001            1000000000001
1000000001            1000000000001
1000000001            1000000000001
1000000001            1000000000001
1000000001            1000000000001
1000000001            1000000000001
1000000001            1000000000001
1000000001            1000000000001
10000000011111111111111000000000001
10000000000000000000000000000000001
10000000000000000000000000000000001
10000000000000000000000000000000001
10000000000000000000000000000000001
10000000000000000000000000000000001
10000000000000000000000000000000001
10000000000000000000000000000000001
10000000000000000000000000000000001
100000000000000000000W0000000000001
10000000000000000000000000000000001
10000000000000000000000000000000001
11111111111111111111111111111111111
