NO levels/paradise/textures/brick2.xpm
SO levels/paradise/textures/window.xpm
WE levels/paradise/textures/brick2.xpm
EA levels/paradise/textures/window.xpm

C 135,206,250
F 107,185,151


11111111111111111111111111111111111111111111111111111111111111111111111111111111111111111111111111111
10000000000000000000000000000000000000000000000000000000000000000000000011111111111111111111111111111
10100001010101001111111001001000010100111100000011101110000000000000000011111111111111111111111111111
10100001000101001100001001001100010101000000000111111111000000000000000011111111111111111111111111111
10100001010101001000001001001010010101000000000111111110000000000000000011111111111111111111111111111
10101001010101001000001001001001010101111100000011111100000000000000000011111111111111111111111111111
10110101010101001100001001001000110100000010000001111000000000000000000011111111111111111111111111111
10100010010101001111111001001000010101111100000000110000000000000000000011111111111111111111111111111
10000000000000000000000000000000000000000000000000000000000000000000000011111111111111111111111111111
10000000000000000000111111111111111111111111111111111111111111111111111111111111111111111111111111111
10000000000000000000111111111111111111111111111111111111111111111111111111111111111111111111111111111
100000000000000000001111111111111111111111111111111111111111111111111111111111111
10000000000000000000111111111111111111111111111111111111111111111111111111111111
10000000000000000000111111111111111111111111111111111111111111111111111111111111
10000000000000001111111111111111111111111111111111111111111111111111111111111111
1000000000000000111111111111111111111111111111111111111111111111111111111111111
1000000000000000111111111111111111111111111111111111111111111111111111111111111
1000000000000000111111111111111111111111111111111111111111111111111111111111111
1000000000000000111111111111111111111111111111111111111111111111111111111111111
10000000000000001111111111111111111111111111111111111111111111111111111111111111111111111111111111111
10000000000000001111111111111111111111111111111111111111111111111111111111111111111111111111111111111
1DDDDDDDDDDDDDDDDDDDDDDDDDDDDDDDDDDDDDDDDDDDDDDDDDDDDDDDDDDDDDDDDDDDDDDDDDDDDDDDDDDDDDDDDDDDDDDDDDDD1
10000000000000000000000000000000000000000000000000000000000000000000000000000000000000000000000000001
100010000000000000000000000000000000000000000000000000000000000000000000000000000000000000000000000001
100010000000000000000000000000000000000000000000000000000000000000000000000000000000000000000000000001
10000000000000000000000000000000000000000000000000000000000000000000000000000000000000000000000000001
100W0000000000000000000000000000000000000000000000000000000000000000000000000000000000000000000000001
10000000000000000000000000000000000000000000000000000000000000000000000000000000000000000000000000001
10000000000000000000000000000000000000000000000000000000000000000000000000000000000000000000000000001
10000000000000000000000000000000000000000000000000000000000000000000000000000000000000000000000000001
10000000000000000000000000000000000000000000000000000000000000000000000000000000000000000000000000001
10000000000000000000000000000000000000000000000000000000000000000000000000000000000000000000000000001
1D111111111111111111111111111111111111111111111111111111111111111111111111111111111111111111111111011
1D111111111111111111111111111111111111111111111111111111111111111111111111111111111111111111111111011
1D11111111111111111111111111111111111111111111111111111111111111111111111111111111111111111111111101
1D1                                                                                              101
10111111111111111111111111111111111111111111111111111111111111111111111111111111111111111111111111011
10000000000000000000000000000000000000000000000000000000000000000000000000000000000000000000000000001
11111111111111111111111111111111111111111111111111111111111111111111111111111111111111111111111111111
