NO levels/paradise/textures/brick2.xpm
SO levels/paradise/textures/brick2.xpm
WE levels/paradise/textures/window.xpm
EA levels/paradise/textures/window.xpm

C 135,206,250
F 107,185,151



1111111
100W001
1000111
1001111
1111111
