NO levels/spaceshiper/spaceship/sprite_1.xpm
SO levels/spaceshiper/spaceship/sprite_4.xpm
WE levels/spaceshiper/spaceship/sprite_9.xpm
EA levels/spaceshiper/spaceship/sprite_7.xpm

C 70,0,70
F 150,130,0

111111111111111111111111111111111111
100000000000000000000000000000000001
100000000000000000000000000000000001
11D110000001111111111111100000011D11
10001000000D000000000000D00000010001
100010000001111100001111100000010001
100010000000000011110000000000010001
100010000000000000000000000000010001
10001D110001111000000111100011D10001
10000001000D001000000100D00010000001
100010010001001000S00100100010010001
100100010001001000000100100010001001
100100110001001111111100100011001001
101000100001000000000000100001000101
101000100011000000000000110001000101
1010001D11100001111110000111D1000111
1010000000000000000000000000000101
1010000000000000000000000000000101
10000000001111110000000011111100001
10000000000000000000000000000000001
11111100000000000000000000000011111
100001D1D1D1D1DDD11100001D1D1D1D1DD11
100001D1D1D1D1DDD11D11D11D1D1D1D1D1111
100000000000000000000000000000000001
100000000000000000000000000000000001
11D110000001111111111111100000011D11
10001000000D000000000000D00000010001
100010000001111100001111100000010001
100010000000000011110000000000010001
100010000000000000000000000000010001
10001D110001111000000111100011D10001
10000001000D001000000100D00010000001
100010010001001000000100100010010001
100100010001001000000100100010001001
100100110001001111111100100011001001
101000100001000000000000100001000101
101000100011000000000000110001000101
1010001D11100001111110000111D1000111
1010000000000000000000000000000101
1010000000000000000000000000000101
10000000001111110000000011111100001
10000000000000000000000000000000001
111111111111111111111111111111111111
